T T T T T T T T T T T T T T T T T T T T
T P F F F F F F F F F F F F F F F F F T
T F F F F F F F F F F F F F F F F F F T
T F F F F F F F F F F F F F F F F F F T
T F F F F F F F F F F F F F F F F F F T
T F F F F F F F F F F F F F F F F F F T
T F F F F F F F F F F F F F F F F F F T
T F F F F F F F F F F F F F F F F F F T
T F F F F F F F F F F F F F F F F F E T
T T T T T T T T T T T T T T T T T T T T
