T T T T T T T T T T T T T T T T T T T T
T P T F F F F F T F F F T F T F F F F T
T F T F T F B F F F T F T F T F T T T T
T F F F T T T T T F T F T F F F F T F T
T F T F T A F F F F T F F F T F F F F T
T F T T T T F T T F T T T F T F F T F T
T F T F F T F F T F T F F F T F C T F T
T F T F T T T F T T T F T F T T T T F T
T F F F F F F F T L F F T F F F F T E T
T T T T T T T T T T T T T T T T T T T T
