T T T T T T T T T T T T T T T T T T T T
T P F F T F T F T F B F T F F F F F F T
T F F F T F F F T F F F F F F F F F F T
T T F T T F T F T F F F T F F F F F F T
T F F F F F T L T F F F T F F F F F C T
T T F T T T T T T F T T T T T F T T T T
T F F F T F F F F F F T F F F F F F F T
T F F F F F F F F F F T F F F F F F F T
T A F F T F F F F F F T F F F E F F F T
T T T T T T T T T T T T T T T T T T T T
