T T T T T T T T T T T T T T T T T T T T
T F L T A F T F F T B F T F F T F F F T
T F T T F F F F F T F F F F F T F E F T
T F F T F F T F F T F F T T F T F F F T
T T F T F F T F F T F F T F F T F F F T
T F F T F F T F F T F F T F F T F F F T
T F T T T F T F F T T F T F F T F F F T
T F F F F F T F F F F F T F F F F F F T
T P F T F F T F F T F F T F F T F C F T
T T T T T T T T T T T T T T T T T T T T
