T T T T T T T T T T T T T T T T T T T T
T A F F F F F F F F F F F T F F F T L T
T F F F F F F F T T T T F T F F F T F T
T F F T T T F F T E F T F T F F F F F T
T F F T F F F F T F F T F F F F F F F T
T F F T C T F F T F F F F T F F F F F T
T F F T T T F F T F F T F T F F F F F T
T F F F F F F F T T T T F T F F F T F T
T P F F F F F F F F F F F T F F F T B T
T T T T T T T T T T T T T T T T T T T T
