T T T T T T T T T T T T T T T T T T T T
T P F F F F T F F F F F T F F F F F L T
T F F F F F T F F B F F F F F F F F F T
T F F F F F T F F F F F T F F F F T T T
T F F F F F T F F F F F T F F F F F F T
T F F F F F T F F F F F T F F F F F C T
T F F F F F T F F F F F T F F F F T T T
T F F A F F F F F F F F T F F F F F F T
T F F F F F T F F F F F T F F F F F E T
T T T T T T T T T T T T T T T T T T T T
