T T T T T T T T T T T T T T T T T T T T
T P F F T F T F T F F F T F F F T F L T
T T T F T F T F F F T F T F T F F F T T
T F F F F F T F T T T F T F T T T T E T
T F T T T T T F T B F F F F F T F F F T
T F T F F F F F T T T T T T F T F T T T
T F F F T T T F T F F T F F F F F F F T
T F T F T A T F T T F T F T F T T T F T
T F T F F F T F F F F F F T F F F T C T
T T T T T T T T T T T T T T T T T T T T
