T T T T T F F F F F T T T T T F T T T F
T F F F T T T T T T T F F F T T T L T F
T F P F F F F F F F F F F F F F F F T F
T F F F T T T F F F T F F F T T T B T F
T T F T T F T F F F T T F T T F T T T F
F T F T F F T T T T T F F F T F F F F F
T T F T T T T F F F T F F F T T T T T T
T F F F F F F F A F T F C F F F F F F T
T T T T T T T F F F T T T T T T F F E T
F F F F F F T T T T T F F F F T T T T T
