F F F F F F F F F F F F F F F T T T F F
F T T T T T F F T T T T T T T T B T F F
F T F A F T F F T F F F F F F F F T F F
F T F F F T F T T F T T T T T T T T T T
F T F F F T T T F F F T F F F F F T F T
F T F F F F F F F P F F F F F F F F C T
F T F F F T T T F F F T F F F F F T F T
F T F F F T F T T F T T T T T T F T T T
F T F F F T F T E F F T F F F T L T F F
F T T T T T F T T T T T F F F T T T F F
