F T T T T T T T T T T T F F F F F F F F
F T F F F F F F F F C T T T T T T T T T
F T F F F F F F F F F T F F F F F F F T
F T F F F F F F F F F T F F F F F B F T
T T T F T T T T T F T T F F F F F F F T
T F F F F F F T F F F F F F F T T F T T
T F F F F T F T T T T T T F T T F F F T
T F A F F T F T F P F T F E F T F L F T
T F F F F T F F F F F T F F F T F F F T
T T T T T T T T T T T T T T T T T T T T
