T T T T T T T T T T T T T T T T T T T T
T F F P F F T F F F F F F F F F F F C T
T F F F F F F F F F F F F F F F F F F T
T F F F F F T T T T T T T T T T F T T T
T F F F F F T F F F F T F F F T F F E T
T F F F F F T L F T F F F T F F F F F T
T F F F F F T T F T T T T T T T T T T T
T F F A F F F F F F F F F F F F F F F T
T F F F F F T F F F F F F F F F F F B T
T T T T T T T T T T T T T T T T T T T T
