F F F F F F F F F F F F F F F F F F F F
F F F F F F F F F F F F F F F F F F F F
F F F F F T T T T T T T T T F F F F F F
F F F F F T F F F S F F F T F F F F F F
F F F F F T P F F F F F E T F F F F F F
F F F F F T F F F F F F F T F F F F F F
F F F F F T T T T T T T T T F F F F F F
F F F F F F F F F F F F F F F F F F F F
F F F F F F F F F F F F F F F F F F F F
F F F F F F F F F F F F F F F F F F F F
