T T T T T T T T T T T T T T T T T F F F
T F P F T F F F T F F F T F F F T F F F
T F F F T F A F T F B F T F C F T F F F
T F L F T F F F T F F F T F F F T F F F
T F F F T F F F T F F F T F F F T F F F
T F F F T T F T T T F T T T F T T T T T
T F F F T F F F T F F F T F F F T F F T
T F S F F F F F F F F F F F F F F F E T
T F F F T F F F T F F F T F F F T F F T
T T T T T T T T T T T T T T T T T T T T
